WWWWWWWWWWWWWWWWWWW
WSSSSSSSSWSSSSSSSSW
WSWWSWWWSWSWWWSWWSW
WSSSSSSSSSSSSSSSSSW
WSWWSWSWWWWWSWSWWSW
WSSSSWSSSWSSSWSSSSW
WWWWSWWWSWSWWWSWWWW
SSSWSWSSSSSSSWSWSSS
WWWWSWSWSWSWSWSWWWW
SSSSSSSWSSSWSSSSSSS
WWWWSWSWWWWWSWSWWWW
SSSWSWSSSPSSSWSWSSS
WWWWSWSWWWWWSWSWWWW
WSSSSSSSSWSSSSSSSSW
WSWWSWWWSWSWWWSWWSW
WSSWSSSSSSSSSSSWSSW
WWSWSWSWWWWWSWSWSWW
WSSSSWSSSWSSSWSSSSW
WSWWWWWWSWSWWWWWWSW
WSSSSSSSSSSSSSSSSSW
WWWWWWWWWWWWWWWWWWW